1111111111111
10010000000C1
1000011111001
1P0011E000011
1000000000001
1000000000001
1000000000111
10000000001C1
1111111111111