1111111111111
10010000000C1
1000011111001
1P0011E000011
1000000000000
1000000000111
1000000000111
1111111111111