1111111111111
10010000000C1
1000011111001
1P0011E000011
1000100000001
1001100000001
1001111011111
10000000000C1
1111111111111