1111111111111111111111111111111111111111
1000000000000000000000000000000000000001
100P000000000000000000000000000000000E01
1000000000000000000000000000000000000001
1000000000000000000000000000000000000001
1111111111111111111111111111110111111111
1111111111111111111111111111110111111111
1111111111111111111110000000000111111111
1111111111111111111110111111111111111111
1111111000000000000000000000000111111111
1111111011111111111111111111110111111111
1111111011111111111111111111110111111111
1111111011111111111111111111110111111111
1111000000000000001111111111110111111111
1110011111111111100000100000000111111111
1111111111111111111110111111111111111111
1CCCCCCCCCCCCCCCCCCCCCCCCCCCCCCCCCCCCCC1
1CCCCCCCCCCCCCCCCCCCCCCCCCCCCCCCCCCCCCC1
1CCCCCCCCCCCCCCCCCCCCCCCCCCCCCCCCCCCCCC1
1CCCCCCCCCCCCCCCCCCCCCCCCCCCCCCCCCCCCCC1
1111111111111111111111111111111111111111